WWWWWWWWWWWWWWWWWWWWWWWWWWWWWWWW
W#TW WW  W W WW W  W #WW WWWWWtW
WcWW  WW W# #    W # WW       #W
W## W  #   W W W   W W cWWW#WWWW
W#W W W WW   W W W W   WWW   WWW
W   W W #t W  WW W W W W  tW  WW
W W W WW#WWWW c  WWW W cW WWW  W
W W   W    W  WWW W W W W T W  W
W WWW #WWW W WWWW W#W W W W    W
W  WTW## W W  WcW W   W   W W WW
WW W#W#W   W WW W W#W W WWW    W
W  W###WWW  W     W#W   W  #W WW
WW  WWW   W   W W    WWW W W  WW
W  Wt W W WWWcW  WWWWW       WWW
W W W#WWW    WW W WW   W #WWW WW
W W ccW  WWW    t  W W WW  ##  W
W t W# cW    W W A   W WW WWWW W
WWW W WWW W W W  WWWWW WW  WW  W
W   W W W W       Wt#WW WW#W  WW
W WWW W # W WWWWWWWW WW W  WW WW
W Wt #c W # #ccccctW c   W WW  W
W WWWWW W W WWWWWWWWtW W   W  WW
W W  W    W    #c   #W W W WW WW
W WW WW W WWWW WWWWWWWWWWW WW  W
W Wt#W  c WWWW WWW   c  W  WW WW
W WW WW W  ##W W   W  W W     TW
W WW #W W WW   #   W  WWWWW WWWW
W WW WW W W  W WWW  W   W   WWWW
W  W c cW W WW# c W W W WWW   WW
WW   W W  W   WWW W W W  WW WWWW
WT W WWWW   W# c      W     WWWW
WWWWWWWWWWWWWWWWWWWWWWWWWWWWWWWW